111111111111
1000000P0011
1C0000C11111
110000000C01
1111E0000001
111111111111