1111111111111
1000C010C0001
1000000000001
1000010100001
10C011P110C01
100001C100001
1000000000001
1000C010C0001
1111111111111