1111111111111
1000C010C0001
1000000000001
1000E101E0001
10C0110110C01
1000E1C1E0001
1000000000001
1000C010C0001
1111111111111